     11111
1111110001
10000N0001
1000000001
1000000001

100000000111
100000000001
111111111111