R 800 600
NO ./textures/tree_wall.xpm
SO ./textures/tree_wall.xpm
WE ./textures/tree_wall.xpm
EA ./textures/tree_wall.xpm
S ./textures/tree_snow.xpm
F 44,31,14
C 19,24,15


     11111
1111110001
1020000001
1000000001
1000000001
100000200111
1000000000N1
111111111111
