F 246 ,     208 ,    95

SO       ./textures/SO.xpm

R 800 600

WE   ./textures/WE.xpm
EA      ./textures/EA.xpm

S    ./textures/S.xpm
NO         ./textures/NO.xpm

C        191,97,106


11111111111111111111
10000000000000000001
111110020000000000011111
    100000N0000000000001
    10000000000000000001
    10000000000200011111
11111000000000000001
10000000000000000001
11111111111111111111
