     11111
11111100N1
1000N00001
1000000001
1000000001
            
100000000111
1000000W0000
111111111111