     11111
1111110001
1000000001
1000000001
1000000001
100000000111
100000000000
111111111111