R 920 700
NO ./textures/tree_wall.xpm
SO ./textures/tree_wall.xpm
WE ./textures/tree_wall.xpm
EA ./textures/tree_wall.xpm
S ./textures/tree.xpm
F 44,31,14
C 19,24,15

1111111111111
1000000000001
1000000000001
1000000000001
1000100000001
1002000000001
1000200000001
1000000000001
1000000000001
100N000000001
1111111111111
