R 1200 920
NO ./textures/tile.xpm
SO ./textures/tile.xpm
WE ./textures/tile.xpm
EA ./textures/tile.xpm
S ./textures/ghost.xpm
F 106, 158, 25
C 98, 200, 243

1111111111111                                  11111111111111111111111111111
1001000000001                                  10000000000000000000000000001
1001000000001111111111111111111111111111111111110000000000000000000000000001
1001001110000000001000000000001000000000000000000000000000011111111111111111
1001001000000000001000000000001000000000000000000000000000000000000000000001
1001001000000000001000000000000000000000000000200000000000000000000000000001
1001001000002000001000000000001000000000000000000000000000000000000000000001
10010000000000000000000000000010000E0000000002000020000000000000000020000001
1001111000000000000000000000000000000000000000020000000000000000000000000001
1000000000000000000000000000000000000000000000000000002000000000000000000001
1001111000000000000000000000000000000000000000020000000000000000000000000001
1001000000111111111110000000000000000000000000000000000000000000000000000001
10010200001         10000000000000000200000000000000000000000000000000000001
10010000001         10000000000000000000000000000000000000000000000000000001
10010000001         10000020000000000000000000000000000000000000000000000001
10010000001         10000000000002000000000000000000000000000000000000000001
11111111111         111000000000000000000000111111111111111111111111111111111111111111
                    100000000000000000000000000000000000000000000000000000000000000001
                    100020000000000000000000000000000000000000000000000000000020000001
                    100000000000020000000000000000000000000000000000000000000000000001
                    100002000000000000000000000000000000000002000000000000000002000001
                    100000000000000000000000000000000000000000000000000000000000000001
                    111111111111111111111111111111111111111111111111111111111111111111