R 920 700
NO ./textures/tile.xpm
SO ./textures/tile.xpm
WE ./textures/tile.xpm
EA ./textures/tile.xpm
S ./textures/ghost.xpm
F 106, 158, 25
C 98, 200, 243

1111111111111                                  11111111111111111111111111111
1001000000001                                  10000000000000000000000000001
1001000000001111111111111111111111111111111111110000000000000000000000000001
1001201110000000021000000000001000000000000000000000000000011111111111111111
1001001000000200001000002000001000000000000000000000000000000000000000000001
1001001000000000001000000000000000000000000000200000000000000000000000000001
1001001002000000201000000000001000000000000000000000000000000000000000000001
1001000000000000000000002000001000000000000000000000000000000000000200000001
1001111000000000000000000000000000000000000000000000000000000000000000000001
12000000000000N0000000000002001000000000000000000000000000000000000000000001
1111111111111111111111111111111111111111111111111111111111111111111111111111
