R 920 700
NO ./textures/tile.xpm
SO ./textures/tile.xpm
WE ./textures/tile.xpm
EA ./textures/tile.xpm
S ./textures/ghost.xpm
F 106, 158, 25
C 98, 200, 243

1111111111111                                  11111111111111111111111111111
1001000000001                                  10000000000000000000000000001
1001000000001111111111111111111111111111111111110000000000000000000000000001
1001001110000000001000000000001000000000000000000000000000011111111111111111
1001001000000000001000000000001000000000000000000000000000000000000000000001
1001001000000000001000000000000000000000000000000000000000000000000000000001
1001001000002000001000000000001000000000000000000000000000000000000000000001
1001000000000000000000000000001000000000000000000000000000000000000000000001
1001111000000000001000000000000000000000000000000000000000000000000000000001
1000000000000000E0100000000001000000000000000000000000000000000000000000001
1111111111111111111111111111111111111111111111111111111111111111111111111111
