R 920 700
NO ./textures/candy_wall.xpm
SO ./textures/candy_wall.xpm
WE ./textures/candy_wall.xpm
EA ./textures/candy_wall.xpm
S ./textures/candy_sprite.xpm
F 233, 252, 255
C 98, 200, 243

1111111111111                                  11111111111111111111111111111
1001000000001                                  10000000000000000000000000001
1001000000001111111111111111111111111111111111110000000000000000000000000001
1001201110000000001000000000001000000000000000000000000000011111111111111111
1001001000000200001000000000001000000000000000000000000000000000000000000001
1001001020000000001000000000000000000000000000200000000000000000000000000001
1001001000000000001000000000001000000000000000000000000000000000000000000001
1001000000000000000000000000001000000000000000000000000000000000000200000001
1001111000000000000000002000000000000000000000000000000000000000000000000001
10000000000000N0000000000000001000000000000000000000000000000000000000000001
1000000000000000000000000000000000000000000000000000000000000000000000000001
1000000000000000000000000000000000000000000000000000000000000000000000000001
1000000000000000000000000000000000000000000000000000000000000000000000000001
1000000000000000000000000000000000000000000000000000000000000000000000000001
1000000000000000000000000000000000000000000000000000000000000000000000000001
1000000000000000000000000000000000000000000000000000000000000000000000000001
1111111111111111111111111111111111111111111111111111111111111111111111111111
