R 920 700
NO ./textures/tile.xpm
SO ./textures/tile.xpm
WE ./textures/tile.xpm
EA ./textures/tile.xpm
S ./textures/ghost.xpm
F 106, 158, 25
C 98, 200, 243

1111111111111
1000000000201
1000002000001
1E00000000001
1111111111111